1000011111100001
1000000000000001
1020000000000001
1000000000000001
1000000000000001
1111111111111111
1111111111111111
1000000000000001
1000000000000001
1000000000000001
1000000000000001
1000011111100001